height 16
width 25
map
     @@@@@@   @@@@@@     
     @....@   @....@     
     @....@   @....@     
     @....@   @....@     
     @....@   @....@     
@@@@@@@..@@@@@@@..@@@@@@@
@....@.............@....@
@.......................@
@.......................@
@....@.............@....@
@@@@@@@..@@@@@@@..@@@@@@@
     @....@   @....@     
     @....@   @....@     
     @....@   @....@     
     @....@   @....@     
     @@@@@@   @@@@@@     