height 16
width 26
map
@@@@@@@@@@@@@@@@@@@@@@@@@@
@....@....@....@....@....@
@.X..D....D....D.X..D.X..@
@....@....@.X..@....@....@
@....@.X..@....@....@....@
@@D@@@@@@@@@D@@@@D@@@@D@@@
@....@....@....@....@....@
@.X..D.X..@.X..@....@.X..@
@....@....@....@.X..@....@
@....@....@....@....@....@
@@D@@@@D@@@@D@@@@D@@@@D@@@
@....@....@.X..@....@....@
@.X..@.X..D....D....D.X..@
@....@....@....@.X..@....@
@....@....@....@....@....@
@@@@@@@@@@@@@@@@@@@@@@@@@@

