height 13
width 13
map
@@@@@@@@@@@@@
@...@...@...@
@.X.D...D...@
@...@...@...@
@@D@@@@@@@D@@
@...@...@...@
@...D...@...@
@...@...@...@
@@D@@@D@@@D@@
@...@...@...@
@...@...D...@
@...@...@...@
@@@@@@@@@@@@@

