height 13
width 16
map
@@@@@@@@@@@@@@@@
@..............@
@.X............@
@..............@
@@@D@@.........@
@....@.........@
@....@@@@@@@D@@@
@....@.........@
@@@D@@.........@
@..............@
@..............@
@..............@
@@@@@@@@@@@@@@@@


